Alho e Óleo	Molho, mussarela, alho e óleo, orégano	20
Alicci	Molho, mussarela, alicci e orégano	20
Americana	molho, mussarela, bacon, milho, ovos e orégano	21
Atum	Molho, mussarela, atum e orégano	22
Bacon	Molho, mussarela, bacon e orégano	21
Baiana	Molho, mussarela, calabresa, pimenta e orégano	25
Bolonhesa	Molho, mussarela, carne moída e orégano	25
Brasileira	Molho, mussarela, milho, ervilha e orégano	20
Brócolis	Molho, mussarela, brócolis, bacon, catupiry e orégano	21
Calabresa	Molho, mussarela, calabresa e orégano	22
Calabresa com Catupiry	Molho, mussarela, calabresa, catupiry e orégano	23
Calabresa com Cheddar	Molho, mussarela, calabresa, cheddar e orégano	23
Calabresa Mineira	Molho, mussarela, calabresa, milho, bacon e orégano	23
Camponesa	Molho, mussarela, frango, tomate picado, gorgonzola e manjericão	22
Catupiry	Molho, mussarela, catupiry e orégano	21
Champignon	Molho, mussarela, champignon e orégano	25
Crocante	Molho, mussarela, presunto, bacon, milho, batata palha e orégano	24
Escarola	Molho, mussarela, escarola, alho, bacon e orégano	23
Frango	Molho, mussarela, frango e orégano	21
Frango Caipira	Molho, mussarela, frango, catupiry, bacon, milho e orégano	22
Frango com Catupiry	Molho, mussarela, frango, catupiry e orégano	22
Frango com Cheddar	Molho, mussarela, frango, cheddar e orégano	22
Gorgonzola	Molho, mussarela, tomate, gorgonzola e orégano	26
Grega	Molho, mussarela, lombo, cebola, palmito e orégano	23
Havaiana	Molho, mussarela, lombo e abacaxi	23
Humita	Molho, mussarela, presunto, milho e orégano	22
Lombo	Molho, mussarela, lombo e orégano	22
Lombo Califórnia	Molho, mussarela, lombo, califórnia e orégano	23
Lombo Canadense	Molho, mussarela, lombo, tomate, alicci, parmesão e orégano	26
Lombo com Catupiry	Molho, mussarela, lombo, catupiry e orégano	24
Lombo com Champignon	Molho, mussarela, lombo, champignon e orégano	24
Lombo com Cheddar	Molho, mussarela, lombo, cheddar e orégano	24
Lombo Especial	Molho, mussarela, lombo, champignon, catupiry e orégano	27
Maguerita	Molho, mussarela, tomate e manjericão	18
Maiale	Molho, mussarela, lombo, calabresa, bacon e orégano	22
Marinara	Molho, mussarela, atum, tomate picado, provolone e orégano	23
Mexicana	Molho, mussarela, calabresa, cebola, pimenta e orégano	22
Milho Verde	Molho, mussarela, milho verde e orégano	23
Mussarela	Molho, mussarela e orégano	17
Napolitana	Molho, mussarela, tomate, parmesão e orégano	20
Palmito	Molho, mussarela, palmito e orégano	21
Palmito Especial	Molho, mussarela, palmito, milho, bacon e orégano	23
Parmegiana	Mussarela, molho ao sugo, parmesão e orégano	25
Paulista	Molho, mussarela, palmito, ervilha e orégano	23
Peruana	Massa, molho, mussarela, atum, cebola, ervilha e orégano	23
Portuguesa	Molho, mussarela, presunto, cebola, ovos, azeitona e orégano	26
Provolone	Molho, mussarela, provolone e orégano	25
Q'Delícia	Molho, mussarela, bolonhesa, cebola, batata palha e orégano	27
Quatro Queijos	Molho, mussarela, provolone, parmesão, catupiry e orégano	29
Romana	Molho, mussarela, presunto e orégano	23
Siciliana	Molho, mussarela, champignon, bacon, pimentão, azeitona e orégano	30
Vegetariana	Molho, mussarela, escarola, tomate, milho, ervilha e orégano	24